CCCVCCECECCCBCCCBCCVCCCVCCCCVECCCVCBCCVBMMME
CCCCCCECECCCCCCBBCCCCCCCCCCMCECCBCLVBVVEEEEE
MCCVCCCCECCCBCCCBCCVCECVCCCVMCCCCVVBCCBCVCVE
MCCFCCCCCCBZBCLCZVVLCEVCCVCCZMCCCBVCCZVBVPBE
MCCVCCCCVCCCBCCCBCCVCEBVCCCBMCCCBVVVVBVCBBCE
CCCVVVVVECCCBCCCBCCVCECVCCCMCCCCVVBBVVCEEEEE
CCCVCCECECCCBCCCBCCVCCCVCCBCCECCBVLVCVCCVCBE
CCCVCCECECCCBCCCBCCVCCCVCCCCCECCVBCBCBCBMMME