CCCVCCECECCCBCCCBCCVCCCVCCCCCCCCCVCBCCCBVBCCCBBCBCBCVBCVBCB
CCCCCCECECCCCCCBBCCCCCCCCCCCCCCCBCCVBVVVVBCCVVCBCVCCCBBVBCC
CCCVCCCCECCCBCCCBCCVCCMVCCCCCCCCCVVBCCCCBCVCVCVVVVCBVCBBCVC
CCCVMMMCCCCZBCLCBVVVCVMCCVCCCCCCCBVCCVVCVBVVBCVBBBCBCVVVVVC
CCCVCCCCVCCCBCCCBCCVCCMVCCCCCCCCBVVVVCVBVCBBCCBBCBBVCCVVVBC
CCCVVVVVECCCBCCCBCCVCCCVCCCCCCCCVBVBVBBVCVVVVBVBCBBCBCCVCVC
CCCVCCECECCCBCCCBCCVCCCVCCCCCCCCBVCVCVCVCCVCBVVVCVBBBBBBVBV
CCCVCCECECCCBCCCBCCVCCCVCCCCCCCCVBCBCBCBCBVVBCBBVBCCCBBCCVB