CCCVCCECECCCBCCCBCCVCCCVCCCCVECCCVCBCCVBCCCE
CCCCCCECECCCCCCBBCCCCCCCCCCMCECCBCLVBVVEEEEE
MCCVCCCCECCCBCCCBCCVCECVCCCVMCCCCVVBCCBCVCVE
MCCFCCCCCCAZBCLCZVVLCEVCCVCCZMCCCBVCCZVBVPBE
MCCVCCCCVCCCBCCCBCCVCEBVCCCBMCCCBVVVVBVCBBCE
CCCVVVVVECCCBCCCBCCVCECVCCCMCCCCVVBBVVCEEEEE
CCCVCCECECCCBCCCBCCVCCCVCCMCCECCBVLVCVCCVCBE
CCCVCCECECCCBCCCBCCVCCCVCCCCCECCVBCBCBCBVVBE