CCCVCCECECCCBCCCBCCVCCCVCCCCCCCCCVCBCCVBCCCB
CCCCCCECECCCCCCBBCCCCCCCCCCCCCCCBCCVBVVBCCVV
MCCVCCCCECCCBCCCBCCVCECVCCCMCCCCCVVBCCBCVCVC
MCCFCCCCCCCZBCLCZVVLCEVCCVCCMCCCCBVCCVVBVPBC
MCCVCCCCVCCCBCCCBCCVCEBVCCCMCCCCBVVVVBVCBBCC
CCCVVVVVECCCBCCCBCCVCECVCCCCCCCCVBVBVVCVVVVB
CCCVCCECECCCBCCCBCCVCCCVCCCCCCCCBVCVCVCCVCBV
CCCVCCECECCCBCCCBCCVCCCVCCCCCCCCVBCBCBCBVVBC