CCCVCCCCECCCBCCCBCCVCCCVCCCCCC
CCCCCCCCCCCCCCCBBCCCCCCCCCCCCC
CCCVCCCCECCCBCCCBCCVCCCVCCCCCC
CCCVCCCCCCCCBCCCBVVVCVCCCVCCCC
CCCVCCCCECCCBCCCBCCVCCCVCCCCCC
CCCVVVVVVCCCBCCCBCCVCCCVCCCCCC
CCCVCCCCECCCBCCCBCCVCCCVCCCCCC
CCCVCCCCCCCCBCCCBCCVCCCVCCCCCC
