CCCVCCECECCCBCCCBCCVCCCVCCCCVECCCVCBCCVBMMME
CCCCCCECECCCCCCBBCCCCCCCCCCMCECCECLVBVVEEEEE
MCCVCCCCECCCBCCCBCCVCECVCCCVMCCCCVVBCCBCVCVE
MCCFCCCCCCBZBCLCZVVLCEVCCZCCZMCCEBVCCZVBVPBE
MCCVCCCCVCCCBCCCBCCVCEBVCCCBMCCCBVVVVBVCBBCE
CCCVVVVVECCCBCCCBCCVCECVCCCMCCCCEVBBVVCEEEEE
CCCVCCECECCCBCCCBCCVCCCVCCBCCECCBVLVCVCCVCBE
CCCVCCECECCCBCCCBCCVCCCVCCCCCECCEBCBCBCBMMME