CCCVCCCCECCCBCCCBCCVCCCVCCCCCC
CCCCCCCCCCCCCCCBBCCCCCCCCCCCCC
CCCVCCCCECCCBCCCBCCVCCMVCCCCCC
CCCVCCCCCCCCBCCCBVVVCVMCCVCCCC
CCCVCCCCECCCBCCCBCCVCCMVCCCCCC
CCCVVVVVVCCCBCCCBCCVCCCVCCCCCC
CCCVCCCCECCCBCCCBCCVCCCVCCCCCC
CCCVCCCCCCCCBCCCBCCVCCCVCCCCCC
