CCCVCCECECCCBCCCBCCVCCCVCCCCVECCCVCBCCVBCCCE
CCCCCCECECCCCCCBBCCCCCCCCCCMCECCBCLVBVVEEEEE
MCCVCCCCECCCBCCCBCCVCECVCCCVMCCCCVVBCCBCVCVE
MCCFCCCCCCBZBCLCZVVLCEVCCVCCZMCCCBVCCZVBVPBE
MCCVCCCCVCCCBCCCBCCVCEBVCCCBMCCCBVVVVBVCBBCE
CCCVVVVVECCCBCCCBCCVCECVCCCMCCCCVVBBVVCEEEEE
CCCVCCECECCCBCCCBCCVCCCVCCBCCECCBVLVCVCCVCBE
CCCVCCECECCCBCCCBCCVCCCVCCCCCECCVBCBCBCBVVBE