CCCVCCECECCCBCCCBCCVCCCVCCCCVECCMVCBCCVBMMME
CCCCCCECECCCCCCBBCCCCCCCCCCMCECCECLVBVVEEEEE
MCCVCCCCECCCBCCCBCCVCECVCCCVMCCCMVVBCCBCVCVE
MCCFCCCCCCBZBCLCZVVLCEVCCZCCZMCCEBVCCZVBVPBE
MCCVCCCCVCCCBCCCBCCVCEBVCCCBMCCCMVVVVBVCBBCE
MCCVVVVVECCCBCCCBCCVCECVCCCMCCCCEVBBVVCEEEEE
CCCVCCECECCCBCCCBCCVCCCVCCBCCECCMVLVCVCCVCBE
CCCVCCECECCCBCCCBCCVCCCVCCCCCECCEBCBCBCBMMME