CCCVCCCCCCCCBCCCBCCVCCCVCCCCCC
CCCCCCCCCCCCCCCBBCCCCCCCCCCCCC
CCCVCCCCCCCCBCCCBCCVCCCVCCCCCC
CCCVCCCCCCCCBCCCBVVVCVCCCVCCCC
CCCVCCCCCCCCBCCCBCCVCCCVCCCCCC
CCCVVVVVVCCCBCCCBCCVCCCVCCCCCC
CCCVCCCCCCCCBCCCBCCVCCCVCCCCCC
CCCCCCCCCCCCCCCBBCCCCCCCCCCCCC
CCCVCCCCCCCCBCCCBCCVCCCVCCCCCC
CCCVCCCCCCCCBCCCBVVVCVCCCVCCCC
CCCVCCCCCCCCBCCCBCCVCCCVCCCCCC
CCCVVVVVVCCCBCCCBCCVCCCVCCCCCC